#########
E-#-----#
#-#-###-#
#-#####-#
#-------#
#########