###################
E--######---------#
#--------###----#-#
#-########--####--#
#--------#--------#
#######--#-########
#--------#--------#
#--##############-#
#-----------------#
###################