###################
#-----------------#
#--------#-##-###-#
#--------#--####--#
########-#--------#
########-#-########
#--------#--------E
#--------########-#
#-----------------#
###################