###################
#-----------------#
#--------###----#-#
#-########--####--#
#--------#--------#
#######--#-########
E--------#--------#
#--##############-#
#-----------------#
###################