###################
#--#-----##-------#
#--#---#-#-#----#-#
#------#-#--####--#
########-#--------#
#--------#-########
#--####--#--------#
#-#####--########-#
#-##--------------#
###################