###################
#-----------------#
#-###############-#
#--------#--------#
#--------#-########
#######--#--------#
#--------#--------#
#-###############-#
#-----------------#
###################