#########
#-#-----#
#-#-###-#
#-#####-#
#-------#
#########